{
   "ar"   : "es",
   "au"   : "en",
   "be"   : "fr",
   "bo"   : "es",
   "br"   : "pt",
   "ca"   : "en",
   "ch"   : "fr",
   "cl"   : "es",
   "co"   : "es",
   "de"   : "de",
   "ec"   : "es",
   "es"   : "es",
   "fr"   : "fr",
   "gb"   : "en",
   "ie"   : "en",
   "in"   : "en",
   "it"   : "it",
   "mx"   : "es",
   "my"   : "en",
   "oman" : "en",
   "pe"   : "es",
   "ph"   : "en",
   "pl"   : "en",
   "pt"   : "pt",
   "sg"   : "en",
   "tr"   : "tr",
   "us"   : "en",
   "uy"   : "es",
   "ve"   : "es",
   "za"   : "en"
}
